5
8
####
# .#
#  ##
#*@ #
# $ #
#   #
#   #
#####

